; Region Codes
; CODE	DESCRIPTION
AARCT	ANTARTICA	
ABDBI	ABU DHABI	
AFGH	AFGHANISTAN	
AFRICA	AFRICA	
AJMN	AJMAN	
ALADI	LATIN AMERICAN INTEGRATION ASSOCIATION	
ALB	ALBANIA	
ALG	ALGERIA	
AMSAM	AMERICAN SAMOA	
ANDEAN	ANDEAN GROUP	
ANDO	ANDORRA	
ANGOL	ANGOLA	
ANGUIL	ANGUILLA	
ANTA	ANTIGUA AND BARBUDA	
ANZUS	ANZUS PACT	
APEC	ASIA PACIFIC ECONOMIC COOPERATION	
ARABST	LEAGUE OF ARAB STATES	
ARG	ARGENTINA	
ARMEN	ARMENIA	
ARMHG	ARAB MAGHREB UNION	
ARUBA	ARUBA	
ASEAN	ASSOCIATION OF SOUTH EAST ASIAN NATIONS	
ASIA	ASIA	
AUSNZ	AUSTRALIA AND NEW ZEALAND	
AUST	AUSTRIA	
AUSTR	AUSTRALIA	
AZERB	AZERBAIJAN	
BAH	BAHAMAS	
BAHRN	BAHRAIN	
BALTST	BALTIC STATES	
BANDH	BANGLADESH	
BARB	BARBADOS	
BELG	BELGIUM	
BELZ	BELIZE	
BENIN	BENIN	
BENLUX	BENELUX	
BERM	BERMUDA	
BHUTAN	BHUTAN	
BIOT	BRITISH INDIAN OCEAN TERRITORY	
BOL	BOLIVIA	
BOTS	BOTSWANA	
BRAZ	BRAZIL	
BRUNEI	BRUNEI	
BSHZG	BOSNIA-HERZEGOVINA	
BUL	BULGARIA	
BURMA	MYANMAR (BURMA)	
BURUN	BURUNDI	
BVI	BRITISH VIRGIN ISLANDS	
BYELRS	BELARUS	
CACCM	CENTRAL AMERICAN COMMON MARKET	
CAFR	CENTRAL AFRICAN REPUBLIC	
CAM	CENTRAL AMERICA	
CAMER	CAMEROON	
CANA	CANADA	
CANI	CANARY ISLANDS	
CARCOM	CARIBBEAN COMMUNITY	
CARIB	CARIBBEAN	
CASIA	CENTRAL ASIA	
CAYI	CAYMAN ISLANDS	
CEAFR	CENTRAL AFRICA	
CHAD	CHAD	
CHIL	CHILE	
CHINA	CHINA	
COL	COLOMBIA	
COMOR	COMOROS	
COMWH	COMMONWEALTH	
CONGO	CONGO	
COOKIS	COOK ISLANDS	
COSR	COSTA RICA	
CRTIA	CROATIA	
CUBA	CUBA	
CURAC	CURACO	
CVI	CAPE VERDE	
CYPR	CYPRUS	
CZREP	CZECH REPUBLIC	
DEN	DENMARK	
DEVGCO	DEVELOPING COUNTRIES	
DIEGO	DIEGO GARCIA	
DOMA	DOMINICA	
DOMR	DOMINICAN REPUBLIC	
DUBAI	DUBAI	
EAFR	EAST AFRICA	
EASIA	EASTERN ASIA	
EASTIS	EASTER ISLAND	
ECOWAS	ECONOMIC COUNCIL OF WEST AFRICAN STATES	
ECU	ECUADOR	
EEC	EUROPEAN UNION	
EEUR	EASTERN EUROPE	
EFTA	EUROPEAN FREE TRADE ASSOCIATION	
EGYPT	EGYPT	
ELSAL	EL SALVADOR	
EQGNA	EQUATORIAL GUINEA	
ERTRA	ERITREA	
ESTNIA	ESTONIA	
ETHPA	ETHIOPIA	
EUR	EUROPE	
EUREA	EUROPEAN ECONOMIC AREA	
FAEROE	FAROE ISLANDS	
FALK	FALKLAND ISLANDS	
FEAST	FAR EAST	
FESMIC	FEDERATED STATES OF MICRONESIA	
FGNA	FRENCH GUIANA	
FIJI	FIJI	
FIN	FINLAND	
FPDT	FRENCH PACIFIC DEPTS. AND TERRS.	
FPOLY	FRENCH POLYNESIA	
FRA	FRANCE	
FUJH	FUJAIRAH	
GABON	GABON	
GAMB	GAMBIA	
GCC	GULF COOPERATION COUNCIL	
GFIVE	GROUP OF FIVE	
GFR	GERMANY	
GHANA	GHANA	
GIB	GIBRALTAR	
GREECE	GREECE	
GREENL	GREENLAND	
GREN	GRENADA	
GRGIA	GEORGIA	
GSEVEN	GROUP OF SEVEN	
GTEN	GROUP OF TEN	
GUAD	GUADELOUPE	
GUAM	GUAM	
GUAT	GUATEMALA	
GUBI	GUINEA-BISSAU	
GULFST	GULF STATES	
GUREP	GUINEA	
GUY	GUYANA	
HAIT	HAITI	
HKONG	HONG KONG	
HON	HONDURAS	
HUNG	HUNGARY	
ICEL	ICELAND	
ICST	COTE D'IVOIRE (IVORY COAST)	
INDIA	INDIA	
INDOCH	INDO-CHINA	
INDON	INDONESIA	
INDSUB	INDIAN SUBCONTINENT	
IRAN	IRAN	
IRAQ	IRAQ	
IRE	IRELAND	
ISLAM	ORGANISATION OF THE ISLAMIC CONFERENCE	
ISRAEL	ISRAEL	
ITALY	ITALY	
JAMA	JAMAICA	
JAP	JAPAN	
JORDAN	JORDAN	
KAMPA	CAMBODIA (KAMPUCHEA)	
KAZK	KAZAKHSTAN	
KENYA	KENYA	
KIRB	KIRIBATI (EX. GILBERT ISLANDS)	
KIRGH	KYRGYZSTAN	
KUWAIT	KUWAIT	
LAM	LATIN AMERICA	
LAOS	LAOS	
LATV	LATVIA	
LEBAN	LEBANON	
LESOT	LESOTHO	
LIBER	LIBERIA	
LIBYA	LIBYA	
LIECHT	LIECHTENSTEIN	
LITH	LITHUANIA	
LUX	LUXEMBOURG	
MACAO	MACAO	
MAH	MARSHALL ISLANDS	
MALAG	MADAGASCAR	
MALAW	MALAWI	
MALAY	MALAYSIA	
MALDR	MALDIVES	
MALI	MALI	
MALTA	MALTA	
MARQ	MARTINIQUE	
MAURTN	MAURITANIA	
MAURTS	MAURITIUS	
MCDNIA	MACEDONIA	
MEAST	MIDDLE EAST	
MED	MEDITERRANEAN COUNTRIES	
MEX	MEXICO	
MOLDV	MOLDOVA	
MONAC	MONACO	
MONGLA	MONGOLIA	
MONT	MONTSERRAT	
MOROC	MOROCCO	
MOZAM	MOZAMBIQUE	
MRCSL	MERCOSUL	
NAFR	NORTH AFRICA	
NAFTA	NORTH AMERICAN FREE TRADE AGREEMENT	
NAM	NORTH AMERICA	
NAMIB	NAMIBIA	
NANT	NETHERLANDS ANTILLES	
NATO	NORTH ATLANTIC TREATY ORGANISATION	
NAURU	NAURU	
NEPAL	NEPAL	
NETH	NETHERLANDS	
NEWCAL	NEW CALEDONIA	
NICG	NICARAGUA	
NIGEA	NIGERIA	
NIGER	NIGER	
NIUE	NIUE	
NKOREA	NORTH KOREA	
NOMARI	NORTHERN MARIANAS	
NORFIS	NORFOLK ISLAND	
NORW	NORWAY	
NZ	NEW ZEALAND	
OAMS	ORGANISATION OF AMERICAN STATES	
OAPEC	ORG. OF ARAB PET. EXP. COUNTRIES	
OAU	ORGANISATION OF AFRICAN UNITY	
OCEANA	OCEANIA	
OECD	ORG. FOR ECONOMIC COOPERATION AND DEV.	
OILEX	OIL EXPORTING COUNTRIES	
OMAN	OMAN	
OPEC	ORG. OF PETROLEUM EXPORTING COUNTRIES	
PACIS	PACIFIC ISLANDS	
PACRM	PACIFIC RIM	
PAKIS	PAKISTAN	
PALAU	BELAU (FORMERLY PALAU)	
PANA	PANAMA	
PAPNG	PAPUA NEW GUINEA	
PARA	PARAGUAY	
PERU	PERU	
PHLNS	PHILIPPINES	
PITCIS	PITCAIRN ISLAND	
POL	POLAND	
PORL	PORTUGAL	
PST	SAO TOME AND PRINCIPE	
PTAESA	PREF. TRADE AREA, E. & S. AFRICAN STATES	
PURI	PUERTO RICO	
QATAR	QATAR	
RAKH	RAS AL KHAIMAH	
REUNI	REUNION	
ROM	ROMANIA	
RUSS	RUSSIA	
RWANDA	RWANDA	
SAARAB	SAUDI ARABIA	
SAARC	SOUTH ASIAN ASSOCIATION FOR REG. COOP.	
SADCC	SOUTHERN AFRICAN DEVELOPMENT COMMUNITY	
SAFR	SOUTH AFRICA	
SAM	SOUTH AMERICA	
SASIA	SOUTHERN ASIA	
SCAND	SCANDINAVIA	
SEASIA	SOUTHEAST ASIA	
SELA	LATIN AMERICAN ECONOMIC SYSTEM	
SENEG	SENEGAL	
SEYCH	SEYCHELLES	
SHAJH	SHARJAH	
SILEN	SIERRA LEONE	
SINGP	SINGAPORE	
SKIT	ST KITTS AND NEVIS	
SKOREA	SOUTH KOREA	
SLUC	ST LUCIA	
SLVAK	SLOVAK REPUBLIC	
SLVNIA	SLOVENIA	
SMARNO	SAN MARINO	
SOLIL	SOLOMON ISLANDS	
SOMAL	SOMALIA	
SOUAFR	SOUTHERN AFRICA	
SPAIN	SPAIN	
SPSAH	WESTERN SAHARA	
SRILAN	SRI LANKA	
STHEL	ST HELENA	
STPM	ST PIERRE AND MIQUELON	
SUDAN	SUDAN	
SURM	SURINAM	
SVIN	ST VINCENT AND THE GRENADINES	
SWAZD	SWAZILAND	
SWED	SWEDEN	
SWITZ	SWITZERLAND	
SYRIA	SYRIA	
TADZK	TAJIKISTAN	
TAI	DJIBOUTI (AFARS ISSAS)	
TAIWAN	TAIWAN	
TANZA	TANZANIA	
TCAI	TURKS AND CAICOS ISLANDS	
THAIL	THAILAND	
THDWLD	THIRD WORLD	
TIMOR	EAST TIMOR	
TOGO	TOGO	
TOKLAU	TOKELAU	
TONGA	TONGA	
TRSCUN	TRISTAN DA CUNHA	
TRTO	TRINIDAD AND TOBAGO	
TUNIS	TUNISIA	
TURK	TURKEY	
TURKM	TURKMENISTAN	
TVLU	TUVALU	
UAE	UNITED ARAB EMIRATES	
UAQ	UM AL QUAIWAIN	
UGANDA	UGANDA	
UK	UNITED KINGDOM	
UKRN	UKRAINE	
UN	UNITED NATIONS	
UPVOLA	BURKINA FASO (UPPER VOLTA)	
URU	URUGUAY	
USA	UNITED STATES OF AMERICA	
USAAK	UNITED STATES ALASKA	
USAAL	UNITED STATES ALABAMA	
USAAR	UNITED STATES ARKANSAS	
USAAZ	UNITED STATES ARIZONA	
USACA	UNITED STATES CALIFORNIA	
USACO	UNITED STATES COLORADO	
USACT	UNITED STATES CONNNECTICUT	
USADC	UNITED STATES DISTRICT OF COLUMBIA	
USADE	UNITED STATES DELAWARE	
USAFL	UNITED STATES FLORIDA	
USAGA	UNITED STATES GEORGIA	
USAHI	UNITED STATES HAWAII	
USAIA	UNITED STATES IOWA	
USAID	UNITED STATES IDAHO	
USAIL	UNITED STATES ILLINOIS	
USAIN	UNITED STATES INDIANA	
USAKS	UNITED STATES KANSAS	
USAKY	UNITED STATES KENTUCKY	
USALA	UNITED STATES LOUISIANA	
USAMA	UNITED STATES MASSACHUSETTS	
USAMD	UNITED STATES MARYLAND	
USAME	UNITED STATES MAINE	
USAMI	UNITED STATES MICHIGAN	
USAMN	UNITED STATES MINNESOTA	
USAMO	UNITED STATES MISSOURI	
USAMS	UNITED STATES MISSISSIPPI	
USAMT	UNITED STATES MONTANA	
USANC	UNITED STATES NORTH CAROLINA	
USAND	UNITED STATES NORTH DAKOTA	
USANE	UNITED STATES NEBRASKA	
USANH	UNITED STATES NEW HAMPSHIRE	
USANJ	UNITED STATES NEW JERSEY	
USANM	UNITED STATES NEW MEXICO	
USANV	UNITED STATES NEVADA	
USANY	UNITED STATES NEW YORK	
USANYC	UNITED STATES NEW YORK CITY	
USAOK	UNITED STATES OKLAHOMA	
USAOR	UNITED STATES OREGGON	
USAPA	UNITED STATES PENNSYLVANIA	
USARI	UNITED STATES RHODE ISLAND	
USASC	UNITED STATES SOUTH CAROLINA	
USASD	UNITED STATES SOUTH DAKOTA	
USATN	UNITED STATES TENNESSEE	
USATX	UNITED STATES TEXAS	
USAUT	UNITED STATES UTAH	
USAVA	UNITED STATES VIRGINIA	
USAVT	UNITED STATES VERMONT	
USAWA	UNITED STATES WASHINGTON	
USAWI	UNITED STATES WISCONSIN	
USAWV	UNITED STATES WEST VIRGINIA	
USAWY	UNITED STATES WYOMING	
USSR	COMMONWEALTH OF INDEPENDENT STATES	
UZBK	UZBEKISTAN	
VANU	VANUATU (EX. NEW HEBRIDES)	
VCAN	VATICAN	
VEN	VENEZUELA	
VI	U.S. VIRGIN ISLANDS	
VIETN	VIETNAM	
WAFR	WEST AFRICA	
WALLIS	WALLIS FUTUNA ISLANDS	
WASIA	WESTERN ASIA	
WEEC	WEST EUROPE (EXCLUDING EEC)	
WEIND	WEST INDIES	
WESTW	WESTERN WORLD	
WEUR	WESTERN EUROPE	
WORLD	WORLD	
WSOMOA	WESTERN SAMOA	
YEMAR	YEMEN	
YUG	YUGOSLAVIA	
ZAIRE	DEMOCRATIC REPUBLIC OF THE CONGO	
ZAMBIA	ZAMBIA	
ZIMBAB	ZIMBABWE	

